1 1 1 1 1 1 1 1 1 1 1 1 1 1 1 1 1 1 1 1 
1 0 0 0 0 942 0 0 0 0 0 0 0 0 0 0 0 0 0 1 
1 0 0 0 0 942 0 0 0 0 0 0 0 0 0 0 0 0 0 1 
1 0 0 0 0 942 0 0 0 0 0 0 0 0 0 0 0 0 0 1 
1 0 0 0 0 942 0 0 0 0 0 0 0 0 0 0 0 0 0 1 
1 0 0 0 0 942 0 0 0 0 0 0 0 0 0 0 0 0 0 1 
1 0 0 0 0 942 0 0 0 0 0 0 0 0 0 0 0 0 0 1 
1 0 0 0 0 942 0 0 0 0 0 0 0 0 0 0 0 0 0 1 
1 0 0 0 0 941 0 0 0 0 0 0 0 0 0 0 0 0 0 1 
1 1 938 940 939 938 41 40 0 0 37 36 1 1 1 1 1 1 1 2 
1 0 0 0 0 0 0 0 2086 2087 0 0 35 130 1 1 1 1 1 2 
1 0 0 0 0 0 0 0 0 0 0 0 34 130 1 1 1 1 1 2 
1 0 0 0 0 0 0 0 0 0 0 0 130 157 156 155 2 2 2 2 
1 0 0 0 0 0 0 0 0 0 0 0 1056 0 0 0 0 0 0 2 
1 0 0 0 0 0 0 0 0 0 0 0 1056 0 0 0 0 0 0 2 
1 0 0 0 0 0 0 0 0 0 0 0 1056 0 0 0 0 0 0 2 
1 0 0 0 0 0 0 0 0 0 0 0 0 0 0 0 0 0 0 2 
1 1 1 1 1 1 1 1 1 1 1 1 129 161 159 158 2 2 2 2 
