1 1 1 1 1 1 1 1 1 1 1 1 1 1 1 1 1 1 1 1 
1 0 0 0 0 942 0 0 0 0 0 0 0 0 0 0 0 0 0 1 
1 0 0 0 0 942 0 0 0 0 0 0 0 0 0 0 0 0 0 1 
1 0 0 0 0 942 0 0 0 0 0 0 0 0 0 0 0 0 0 1 
1 0 0 0 0 942 0 0 0 0 0 0 0 0 0 0 0 0 0 1 
1 0 0 0 0 942 0 0 0 0 0 0 0 0 0 0 0 0 0 1 
1 0 0 0 0 942 0 0 0 0 0 0 0 0 0 0 0 0 0 1 
1 0 0 0 0 942 0 0 0 0 0 0 0 0 0 0 0 0 0 1 
1 0 0 0 0 941 0 0 0 0 1 1 0 0 0 0 0 0 0 1 
1 897 938 940 939 938 41 40 0 0 37 36 1 1 1 1 1 1 1 2 
1 0 0 0 0 0 0 0 0 2087 0 0 35 130 1 1 1 1 1 2 
1 0 0 0 0 0 0 0 0 0 0 0 34 130 1 1 1 1 1 2 
1 0 0 0 0 0 0 0 0 0 0 0 130 157 156 155 2 2 2 2 
1 0 0 0 0 0 0 0 0 0 0 0 0 0 0 0 0 0 0 2 
1 0 0 0 0 0 0 0 0 0 0 0 0 0 0 0 0 0 0 2 
1 0 0 0 0 0 0 0 0 0 0 0 0 0 0 0 0 0 0 2 
1 0 0 0 0 0 0 0 0 0 0 0 1056 0 0 0 0 0 0 2 
1 0 0 0 0 0 0 0 0 0 0 0 129 161 159 158 2 2 2 2 
1 0 0 0 0 0 0 0 0 0 0 0 129 0 0 0 0 0 0 1 
1 0 0 0 0 0 0 0 0 2099 2097 2099 1 0 0 0 0 0 0 1 
1 2100 2100 2100 2100 2100 2100 2100 2100 2100 2100 2100 1 0 0 0 0 0 0 1 
1 0 0 0 0 0 0 0 0 0 0 0 1 0 0 0 0 0 0 1 
1 0 0 0 0 0 0 0 0 0 0 0 1 0 0 0 0 0 0 1 
1 958 957 956 955 954 953 952 951 950 949 1 1 1 1 1 1 1 1 1 
